"aa" = (/obj/item/defibrillator/loaded,/obj/structure/table/reinforced/rglass,/turf/open/floor/iron/white,/area/shuttle/escape)
"aF" = (/turf/open/space/basic,/turf/closed/wall/mineral/titanium/nodiagonal,/area/shuttle/escape)
"bc" = (/obj/structure/chair/comfy/shuttle{dir = 8},/obj/structure/extinguisher_cabinet/directional/east,/obj/effect/turf_decal/bot,/obj/machinery/light/directional/east,/turf/open/floor/iron/dark,/area/shuttle/escape)
"cO" = (/turf/closed/wall/mineral/titanium,/area/shuttle/escape)
"dh" = (/obj/structure/table/reinforced/rglass,/obj/item/surgery_tray/full,/turf/open/floor/iron/white,/area/shuttle/escape)
"dP" = (/obj/structure/table/reinforced,/obj/machinery/recharger,/obj/machinery/light/directional/north,/obj/machinery/status_display/evac/directional/north,/turf/open/floor/mineral/plastitanium/red,/area/shuttle/escape/brig)
"ex" = (/obj/machinery/computer/communications,/turf/open/floor/mineral/titanium/blue,/area/shuttle/escape)
"eB" = (/obj/effect/turf_decal/delivery,/turf/open/floor/iron/dark/smooth_corner{dir = 4},/area/shuttle/escape)
"fM" = (/obj/structure/table/reinforced,/obj/item/storage/fancy/donut_box,/turf/open/floor/mineral/titanium/blue,/area/shuttle/escape)
"gn" = (/obj/structure/chair/comfy/shuttle{dir = 8},/obj/effect/turf_decal/bot,/obj/machinery/light/directional/east,/obj/machinery/status_display/evac/directional/east,/turf/open/floor/iron/dark/smooth_edge{dir = 4},/area/shuttle/escape)
"gp" = (/obj/structure/chair/comfy/shuttle,/obj/effect/turf_decal/bot,/obj/machinery/light/directional/north,/turf/open/floor/iron/dark,/area/shuttle/escape)
"gB" = (/obj/structure/extinguisher_cabinet/directional/south,/obj/structure/chair/comfy/shuttle{dir = 4},/turf/open/floor/mineral/titanium/blue,/area/shuttle/escape)
"hm" = (/obj/machinery/iv_drip,/obj/structure/bed/medical/emergency,/obj/machinery/light/directional/south,/obj/machinery/status_display/evac/directional/south,/turf/open/floor/iron/white,/area/shuttle/escape)
"hD" = (/obj/machinery/light/directional/east,/obj/machinery/status_display/evac/directional/east,/turf/open/floor/iron/dark/smooth_corner{dir = 1},/area/shuttle/escape)
"iM" = (/obj/effect/spawner/structure/window/reinforced/shuttle,/turf/open/space/basic,/area/shuttle/escape)
"jh" = (/obj/structure/statue/bananium/clown{name = "Literally Tom Fulp"},/turf/open/floor/mineral/bananium,/area/shuttle/escape)
"jF" = (/obj/structure/chair/comfy/shuttle{dir = 8},/obj/machinery/vending/wallmed/directional/east{use_power = 0},/obj/effect/turf_decal/bot,/obj/machinery/light/directional/east,/turf/open/floor/iron/dark,/area/shuttle/escape)
"jJ" = (/obj/structure/chair/comfy/shuttle,/obj/effect/turf_decal/bot,/turf/open/floor/iron/dark,/area/shuttle/escape)
"kI" = (/obj/structure/window/reinforced/plasma/spawner/directional/north,/obj/structure/window/reinforced/plasma/spawner/directional/west,/turf/open/floor/mineral/bananium,/area/shuttle/escape)
"la" = (/obj/structure/table/reinforced,/obj/machinery/recharger,/obj/machinery/light/directional/north,/obj/machinery/status_display/evac/directional/north,/turf/open/floor/mineral/titanium/blue,/area/shuttle/escape)
"lk" = (/obj/effect/spawner/structure/window/reinforced/shuttle,/turf/open/floor/mineral/titanium,/area/shuttle/escape)
"lG" = (/obj/machinery/door/airlock/shuttle{name = "Emergency Shuttle Airlock"},/obj/docking_port/mobile/emergency{name = "FulpStation emergency shuttle"},/turf/open/floor/iron/dark/textured_half{dir = 1},/area/shuttle/escape)
"mD" = (/obj/machinery/status_display/evac/directional/north,/turf/open/floor/iron/dark/smooth_edge{dir = 1},/area/shuttle/escape)
"mN" = (/obj/structure/chair/comfy/shuttle{dir = 4},/turf/open/floor/mineral/plastitanium/red,/area/shuttle/escape/brig)
"oa" = (/obj/structure/table/reinforced,/obj/item/storage/medkit/regular,/obj/item/storage/medkit/regular,/turf/open/floor/mineral/titanium/blue,/area/shuttle/escape)
"op" = (/obj/structure/extinguisher_cabinet/directional/south,/turf/open/floor/iron/dark/textured,/area/shuttle/escape)
"oL" = (/obj/machinery/status_display/evac/directional/south,/turf/open/floor/iron/dark/textured,/area/shuttle/escape)
"pj" = (/obj/effect/spawner/structure/window/reinforced/shuttle,/turf/open/floor/iron/dark,/area/shuttle/escape)
"pV" = (/turf/open/floor/mineral/titanium,/area/shuttle/escape)
"rw" = (/turf/open/floor/mineral/plastitanium/red,/area/shuttle/escape/brig)
"ta" = (/obj/structure/chair/comfy/shuttle{desc = "Something about this chair makes you very uneasy."; dir = 8; name = "dentist's chair"},/turf/open/floor/mineral/plastitanium/red,/area/shuttle/escape/brig)
"ts" = (/obj/machinery/stasis{dir = 4},/turf/open/floor/iron/white,/area/shuttle/escape)
"uN" = (/obj/machinery/recharge_station,/turf/open/floor/iron/dark,/area/shuttle/escape)
"vj" = (/turf/closed/wall/mineral/titanium,/turf/open/floor/plating,/area/shuttle/escape)
"vm" = (/turf/template_noop,/area/template_noop)
"wa" = (/obj/structure/reagent_dispensers/watertank,/obj/effect/turf_decal/delivery,/turf/open/floor/iron/dark,/area/shuttle/escape)
"wF" = (/turf/open/space/basic,/turf/closed/wall/mineral/titanium,/area/shuttle/escape)
"xx" = (/obj/machinery/door/airlock/shuttle{name = "Emergency Shuttle Airlock"},/turf/open/floor/iron/dark/textured_half{dir = 1},/area/shuttle/escape)
"yd" = (/obj/structure/chair/comfy/shuttle{dir = 8},/obj/effect/turf_decal/bot,/turf/open/floor/iron/dark,/area/shuttle/escape)
"yy" = (/obj/structure/chair/office{dir = 1},/turf/open/floor/mineral/titanium,/area/shuttle/escape)
"yG" = (/turf/open/floor/iron/dark,/area/shuttle/escape)
"yH" = (/obj/structure/window/reinforced/plasma/spawner/directional/east,/turf/open/floor/mineral/bananium,/area/shuttle/escape)
"AC" = (/obj/machinery/computer/emergency_shuttle,/turf/open/floor/mineral/titanium/blue,/area/shuttle/escape)
"AZ" = (/turf/open/floor/iron/dark/smooth_edge{dir = 1},/area/shuttle/escape)
"BL" = (/obj/structure/extinguisher_cabinet/directional/east,/obj/structure/table/reinforced/rglass,/obj/item/storage/medkit/regular{pixel_x = 2; pixel_y = 3},/obj/item/storage/medkit/regular{pixel_x = 2; pixel_y = 3},/turf/open/floor/iron/white,/area/shuttle/escape)
"Cj" = (/obj/structure/chair/comfy/shuttle,/turf/open/floor/mineral/plastitanium/red,/area/shuttle/escape/brig)
"Cx" = (/obj/structure/window/reinforced/plasma/spawner/directional/east,/obj/structure/window/reinforced/plasma/spawner/directional/north,/turf/open/floor/mineral/bananium,/area/shuttle/escape)
"CM" = (/obj/structure/chair/comfy/shuttle{dir = 4},/obj/effect/turf_decal/bot,/turf/open/floor/iron/dark,/area/shuttle/escape)
"De" = (/obj/machinery/light/directional/east,/turf/open/floor/iron/dark/smooth_edge{dir = 4},/area/shuttle/escape)
"DO" = (/turf/open/floor/iron/dark/smooth_corner{dir = 4},/area/shuttle/escape)
"EV" = (/obj/structure/window/reinforced/plasma/spawner/directional/east,/obj/structure/window/reinforced/plasma/spawner/directional/south,/turf/open/floor/mineral/bananium,/area/shuttle/escape)
"EW" = (/turf/open/floor/iron/white,/area/shuttle/escape)
"FA" = (/obj/machinery/door/airlock/security/glass{name = "Holding Area"},/obj/effect/mapping_helpers/airlock/access/all/security/general,/turf/open/floor/mineral/plastitanium/red,/area/shuttle/escape/brig)
"Gu" = (/obj/structure/rack,/obj/item/storage/toolbox/electrical{pixel_x = -3; pixel_y = 1},/obj/item/storage/toolbox/mechanical{pixel_y = -1},/obj/item/storage/toolbox/emergency{pixel_x = 3; pixel_y = -5},/turf/open/floor/iron/dark,/area/shuttle/escape)
"Hj" = (/obj/structure/chair/comfy/shuttle{dir = 8},/obj/effect/turf_decal/bot,/turf/open/floor/iron/dark/smooth_edge{dir = 4},/area/shuttle/escape)
"Hk" = (/obj/machinery/door/airlock/command/glass{name = "Cockpit"},/obj/effect/mapping_helpers/airlock/access/all/command/general,/turf/open/floor/mineral/titanium,/area/shuttle/escape)
"HB" = (/obj/structure/window/reinforced/plasma/spawner/directional/south,/turf/open/floor/mineral/bananium,/area/shuttle/escape)
"HP" = (/obj/item/clothing/suit/hazardvest{desc = "A high-visibility lifejacket complete with whistle and slot for oxygen tanks."; name = "emergency lifejacket"},/obj/item/clothing/suit/hazardvest{desc = "A high-visibility lifejacket complete with whistle and slot for oxygen tanks."; name = "emergency lifejacket"},/obj/item/clothing/suit/hazardvest{desc = "A high-visibility lifejacket complete with whistle and slot for oxygen tanks."; name = "emergency lifejacket"},/obj/item/clothing/suit/hazardvest{desc = "A high-visibility lifejacket complete with whistle and slot for oxygen tanks."; name = "emergency lifejacket"},/obj/item/clothing/suit/hazardvest{desc = "A high-visibility lifejacket complete with whistle and slot for oxygen tanks."; name = "emergency lifejacket"},/obj/item/tank/internals/emergency_oxygen{pixel_x = 3},/obj/item/tank/internals/emergency_oxygen{pixel_x = 3},/obj/item/tank/internals/emergency_oxygen{pixel_x = 3},/obj/item/tank/internals/emergency_oxygen{pixel_x = 3},/obj/item/tank/internals/emergency_oxygen{pixel_x = 3},/obj/item/clothing/mask/breath{pixel_x = -3; pixel_y = -3},/obj/item/clothing/mask/breath{pixel_x = -3; pixel_y = -3},/obj/item/clothing/mask/breath{pixel_x = -3; pixel_y = -3},/obj/item/clothing/mask/breath{pixel_x = -3; pixel_y = -3},/obj/item/clothing/mask/breath{pixel_x = -3; pixel_y = -3},/obj/item/clothing/head/utility/hardhat/orange{name = "protective hat"; pixel_y = 9},/obj/item/clothing/head/utility/hardhat/orange{name = "protective hat"; pixel_y = 9},/obj/item/clothing/head/utility/hardhat/orange{name = "protective hat"; pixel_y = 9},/obj/item/clothing/head/utility/hardhat/orange{name = "protective hat"; pixel_y = 9},/obj/item/clothing/head/utility/hardhat/orange{name = "protective hat"; pixel_y = 9},/obj/structure/closet/crate/internals,/obj/effect/turf_decal/bot,/obj/machinery/light/directional/south,/obj/effect/turf_decal/delivery,/turf/open/floor/iron/dark,/area/shuttle/escape)
"IL" = (/turf/open/floor/iron/dark,/turf/closed/wall/mineral/titanium,/area/shuttle/escape)
"Lu" = (/obj/machinery/power/shuttle_engine/propulsion,/turf/template_noop,/area/shuttle/escape)
"LI" = (/turf/closed/wall/mineral/titanium/nodiagonal,/area/shuttle/escape)
"LN" = (/obj/effect/spawner/structure/window/reinforced/shuttle,/turf/closed/wall/mineral/titanium,/area/shuttle/escape)
"Mm" = (/turf/open/floor/iron/dark/textured,/area/shuttle/escape)
"Mn" = (/obj/machinery/light/directional/north,/turf/open/floor/iron/dark/smooth_edge{dir = 1},/area/shuttle/escape)
"MT" = (/obj/structure/table/reinforced,/obj/item/storage/box/zipties,/obj/machinery/light/directional/north,/obj/machinery/status_display/evac/directional/north,/turf/open/floor/mineral/plastitanium/red,/area/shuttle/escape/brig)
"MV" = (/obj/structure/window/reinforced/plasma/spawner/directional/north,/turf/open/floor/mineral/bananium,/area/shuttle/escape)
"NP" = (/obj/effect/turf_decal/delivery,/turf/open/floor/iron/dark/textured,/area/shuttle/escape)
"NQ" = (/obj/machinery/computer/crew,/turf/open/floor/mineral/titanium/blue,/area/shuttle/escape)
"OM" = (/obj/structure/chair/comfy/shuttle{dir = 8},/turf/open/floor/mineral/titanium/blue,/area/shuttle/escape)
"OV" = (/obj/structure/chair/comfy/shuttle{dir = 4},/obj/effect/turf_decal/bot,/obj/machinery/light/directional/west,/obj/machinery/status_display/evac/directional/west,/turf/open/floor/iron/dark/smooth_edge{dir = 8},/area/shuttle/escape)
"OX" = (/obj/structure/extinguisher_cabinet/directional/east,/turf/open/floor/iron/dark/smooth_corner{dir = 8},/area/shuttle/escape)
"Pc" = (/obj/effect/turf_decal/delivery,/turf/open/floor/iron/dark,/area/shuttle/escape)
"RT" = (/obj/machinery/light/directional/east,/turf/open/floor/iron/dark/smooth_corner{dir = 8},/area/shuttle/escape)
"Sf" = (/turf/open/floor/iron/dark/smooth_corner{dir = 1},/area/shuttle/escape)
"SS" = (/obj/machinery/door/airlock/medical/glass{name = "Escape Shuttle Infirmary"},/turf/open/floor/iron/white,/area/shuttle/escape)
"Tv" = (/obj/effect/turf_decal/bot,/obj/machinery/light/directional/west,/obj/machinery/status_display/evac/directional/west,/turf/open/floor/iron/dark/smooth_edge{dir = 8},/area/shuttle/escape)
"TC" = (/obj/structure/chair/comfy/shuttle{dir = 4},/obj/effect/turf_decal/bot,/obj/machinery/light/directional/west,/turf/open/floor/iron/dark,/area/shuttle/escape)
"Ue" = (/obj/structure/window/reinforced/plasma/spawner/directional/south,/obj/structure/window/reinforced/plasma/spawner/directional/west,/turf/open/floor/mineral/bananium,/area/shuttle/escape)
"UK" = (/obj/machinery/light/directional/south,/turf/open/floor/iron/dark/textured,/area/shuttle/escape)
"UU" = (/obj/structure/closet/crate/freezer/blood,/obj/machinery/light/directional/north,/obj/machinery/status_display/evac/directional/north,/turf/open/floor/iron/white,/area/shuttle/escape)
"VA" = (/obj/machinery/power/shuttle_engine/heater,/obj/structure/window/reinforced/plasma/spawner/directional/west,/obj/structure/window/reinforced/plasma/spawner/directional/east,/obj/structure/window/reinforced/plasma/spawner/directional/north,/turf/open/space/basic,/area/shuttle/escape)
"VO" = (/obj/structure/chair/comfy/shuttle{dir = 1},/obj/effect/turf_decal/bot,/turf/open/floor/iron/dark,/area/shuttle/escape)
"VR" = (/turf/open/floor/iron/dark/smooth_edge{dir = 4},/area/shuttle/escape)
"Wu" = (/obj/structure/reagent_dispensers/fueltank,/obj/effect/turf_decal/delivery,/turf/open/floor/iron/dark,/area/shuttle/escape)
"XA" = (/turf/open/floor/iron/dark/smooth_edge,/area/shuttle/escape)
"Yo" = (/obj/machinery/status_display/evac/directional/north,/turf/open/floor/iron/dark/smooth_corner,/area/shuttle/escape)
"Yz" = (/obj/structure/window/reinforced/plasma/spawner/directional/west,/turf/open/floor/mineral/bananium,/area/shuttle/escape)
"YF" = (/obj/machinery/power/shuttle_engine/propulsion,/turf/open/space/basic,/area/shuttle/escape)

(1,1,1) = {"
vmvmvmvmvmvmvmvmcOvmvmvmvmvmvmvmvm
vmvmvmvmvmvmvmcOcOcOvmvmvmvmvmvmvm
vmvmcOcOiMiMiMcOcOcOiMiMiMcOcOvmvm
vmvmcOlaNQACexlalkdPCjCjCjMTcOvmvm
vmvmiMoayyyyyyfMlkmNrwrwrwtaiMvmvm
vmvmiMgBpVpVpVOMlkmNrwrwrwtaiMvmvm
vmiMwFcOiMHkiMcOcOcOiMFAwFiMwFwFvm
cOiMYoAZAZAZAZmDMnmDAZRTcOtsUUwFvj
xxNPMmMmMmMmMmopMmoLMmVRSSEWEWaacO
cOTvMmMmMmMmMmLIpjLIMmVRSSEWEWBLvj
lGNPMmMmMmMmpjgpjJgppjDecOtshmdhvj
cOpjCMMmMmMmPcjJjJjJPcVRcOcOcOILcO
vmiMpjCMMmMmCMkIMVCxydMmAZydpjiMvm
vmvmaFOVMmMmCMYzjhyHydMmMmgnaFvmvm
vmiMiMCMMmMmCMUeHBEVydMmMmHjiMiMvm
cOiMCMMmMmMmMmVOVOVOMmMmMmyGydiMcO
xxNPMmMmMmMmUKMmMmMmUKMmMmMmAZOXcO
cOTvMmMmMmbcLITCMmjFLITCMmMmMmVRLN
xxeBMmMmMmydpjCMMmydpjCMMmMmMmhDcO
cOpjDOMmMmydpjCMMmydpjCMMmMmSfpjcO
VAiMpjDOMmbcLITCMmbcLITCMmSfpjiMVA
YFvmiMpjDOXAXAXAXAXAXAXASfpjiMvmYF
vmvmvmiMpjHPuNwaGuWuuNHPpjiMvmvmvm
vmvmvmvmVAaFVAiMVAiMVAaFVAvmvmvmvm
vmvmvmvmYFvmLuvmYFvmYFvmYFvmvmvmvm
"}
